MODE 2
SIZE 11/70
LIMIT 0/19
COLOR LIMIT 4
STARS 1000/2000/4100
POWERUPS 1/1/1/0
0 0 4 2 2 2 2 2 4 0 0
0 0 4 2 2 11 2 4 0 0 0
0 0 0 4 2 2 2 4 0 0 0
0 0 4 4 4 4 4 0 0 0 0
0 0 3 4 4 4 4 3 0 0 0
0 0 12 4 4 4 12 0 0 0 0
0 0 0 3 4 4 3 0 0 0 0
0 0 0 3 13 3 0 0 0 0 0
0 0 0 5 5 5 5 5 0 0 0
0 0 0 5 5 5 5 0 0 0 0
0 0 1 1 1 10 1 1 0 0 0
0 0 1 1 1 1 1 0 0 0 0
0 0 0 1 1 1 1 0 0 0 0
0 0 0 1 1 1 0 0 0 0 0
0 0 0 4 6 6 4 0 0 0 0
0 0 0 4 6 6 4 0 0 0 0
0 0 0 0 4 14 6 4 0 0 0
0 0 0 0 4 6 6 4 0 0 0
0 0 0 0 0 4 4 4 0 0 0
0 0 0 7 5 5 5 5 7 0 0
0 0 0 7 5 5 5 5 7 0 0
0 0 7 5 5 5 5 7 0 0 0
0 0 7 5 5 15 5 7 0 0 0
0 0 7 7 7 7 7 0 0 0 0
0 0 0 0 0 0 0 0 0 0 0
0 0 0 0 0 0 0 0 0 0 0
0 0 0 0 0 0 0 0 0 0 0
0 0 0 0 0 0 0 0 0 0 0
0 0 0 0 0 0 0 0 0 0 0
0 0 0 0 0 0 0 0 0 0 0
0 0 0 0 0 0 0 0 0 0 0
0 0 0 0 0 0 0 0 0 0 0
0 0 0 0 0 0 0 0 0 0 0
0 0 0 0 0 0 0 0 0 0 0
0 0 0 0 0 0 0 0 0 0 0
0 0 0 0 0 0 0 0 0 0 0
0 0 0 0 0 0 0 0 0 0 0
0 0 0 0 0 0 0 0 0 0 0
0 0 0 0 0 0 0 0 0 0 0
0 0 0 0 0 0 0 0 0 0 0
0 0 0 0 0 0 0 0 0 0 0
0 0 0 0 0 0 0 0 0 0 0
0 0 0 0 0 0 0 0 0 0 0
0 0 0 0 0 0 0 0 0 0 0
0 0 0 0 0 0 0 0 0 0 0
0 0 0 0 0 0 0 0 0 0 0
0 0 0 0 0 0 0 0 0 0 0
0 0 0 0 0 0 0 0 0 0 0
0 0 0 0 0 0 0 0 0 0 0
0 0 0 0 0 0 0 0 0 0 0
0 0 0 0 0 0 0 0 0 0 0
0 0 0 0 0 0 0 0 0 0 0
0 0 0 0 0 0 0 0 0 0 0
0 0 0 0 0 0 0 0 0 0 0
0 0 0 0 0 0 0 0 0 0 0
0 0 0 0 0 0 0 0 0 0 0
0 0 0 0 0 0 0 0 0 0 0
0 0 0 0 0 0 0 0 0 0 0
0 0 0 0 0 0 0 0 0 0 0
0 0 0 0 0 0 0 0 0 0 0
0 0 0 0 0 0 0 0 0 0 0
0 0 0 0 0 0 0 0 0 0 0
0 0 0 0 0 0 0 0 0 0 0
0 0 0 0 0 0 0 0 0 0 0
0 0 0 0 0 0 0 0 0 0 0
0 0 0 0 0 0 0 0 0 0 0
0 0 0 0 0 0 0 0 0 0 0
0 0 0 0 0 0 0 0 0 0 0
0 0 0 0 0 0 0 0 0 0 0
0 0 0 0 0 0 0 0 0 0 0