MODE 2
SIZE 11/70
LIMIT 0/36
COLOR LIMIT 4
STARS 500/1400/2600
POWERUPS 1/1/1/0
0 0 7 12 7 0 0 7 7 13 7
0 7 0 0 7 0 7 0 0 7 0
0 7 0 0 7 0 7 0 0 7 0
18 0 0 18 17 18 0 0 18 0 0
0 7 0 0 7 0 7 0 0 7 0
0 7 0 0 7 0 7 0 0 7 0
0 0 7 7 7 0 0 7 7 7 7
0 18 7 7 18 14 18 7 7 18 0
0 0 7 7 7 0 0 7 0 0 7
0 7 0 0 7 0 7 0 0 7 0
0 7 0 0 7 0 7 0 0 7 0
18 0 0 18 17 18 0 0 18 0 0
0 7 0 0 7 0 7 0 0 7 0
0 7 0 0 7 7 7 0 0 7 0
0 0 2 7 7 0 0 7 7 2 0
0 0 0 2 0 0 2 0 0 0 0
0 0 0 0 2 0 0 2 0 0 0
0 0 0 0 18 0 0 18 0 0 0
0 0 0 0 7 0 0 7 0 0 0
0 0 0 7 0 0 7 0 0 0 0
0 0 0 0 17 7 7 17 0 0 0
0 0 0 0 0 0 0 0 0 0 0
0 0 0 0 0 0 0 0 0 0 0
0 0 0 0 0 0 0 0 0 0 0
0 0 0 0 0 0 0 0 0 0 0
0 0 0 0 0 0 0 0 0 0 0
0 0 0 0 0 0 0 0 0 0 0
0 0 0 0 0 0 0 0 0 0 0
0 0 0 0 0 0 0 0 0 0 0
0 0 0 0 0 0 0 0 0 0 0
0 0 0 0 0 0 0 0 0 0 0
0 0 0 0 0 0 0 0 0 0 0
0 0 0 0 0 0 0 0 0 0 0
0 0 0 0 0 0 0 0 0 0 0
0 0 0 0 0 0 0 0 0 0 0
0 0 0 0 0 0 0 0 0 0 0
0 0 0 0 0 0 0 0 0 0 0
0 0 0 0 0 0 0 0 0 0 0
0 0 0 0 0 0 0 0 0 0 0
0 0 0 0 0 0 0 0 0 0 0
0 0 0 0 0 0 0 0 0 0 0
0 0 0 0 0 0 0 0 0 0 0
0 0 0 0 0 0 0 0 0 0 0
0 0 0 0 0 0 0 0 0 0 0
0 0 0 0 0 0 0 0 0 0 0
0 0 0 0 0 0 0 0 0 0 0
0 0 0 0 0 0 0 0 0 0 0
0 0 0 0 0 0 0 0 0 0 0
0 0 0 0 0 0 0 0 0 0 0
0 0 0 0 0 0 0 0 0 0 0
0 0 0 0 0 0 0 0 0 0 0
0 0 0 0 0 0 0 0 0 0 0
0 0 0 0 0 0 0 0 0 0 0
0 0 0 0 0 0 0 0 0 0 0
0 0 0 0 0 0 0 0 0 0 0
0 0 0 0 0 0 0 0 0 0 0
0 0 0 0 0 0 0 0 0 0 0
0 0 0 0 0 0 0 0 0 0 0
0 0 0 0 0 0 0 0 0 0 0
0 0 0 0 0 0 0 0 0 0 0
0 0 0 0 0 0 0 0 0 0 0
0 0 0 0 0 0 0 0 0 0 0
0 0 0 0 0 0 0 0 0 0 0
0 0 0 0 0 0 0 0 0 0 0
0 0 0 0 0 0 0 0 0 0 0
0 0 0 0 0 0 0 0 0 0 0
0 0 0 0 0 0 0 0 0 0 0
0 0 0 0 0 0 0 0 0 0 0
0 0 0 0 0 0 0 0 0 0 0
0 0 0 0 0 0 0 0 0 0 0