MODE 2
SIZE 11/70
LIMIT 0/20
COLOR LIMIT 4
STARS 500/1500/4600
POWERUPS 1/1/0/0
0 0 0 1 1 1 1 1 0 0 0
0 0 4 1 1 13 1 4 0 0 0
0 0 0 4 1 1 1 4 0 0 0
0 0 0 4 4 1 4 4 0 0 0
0 0 0 4 4 13 4 4 0 0 0
0 0 0 4 4 4 4 0 0 0 0
0 0 5 5 6 6 5 5 0 0 0
0 0 5 5 6 6 5 5 0 0 0
0 0 0 5 15 6 6 15 5 0 0
0 0 0 5 5 6 6 5 5 0 0
0 0 0 0 5 5 3 3 0 0 0
0 0 0 3 3 3 1 1 0 0 0
0 0 0 3 3 12 1 1 0 0 0
0 0 0 8 9 1 1 0 0 0 0
0 0 0 0 4 4 4 0 0 0 0
0 0 0 2 2 4 4 0 0 0 0
0 0 0 0 2 2 2 0 0 0 0
0 0 0 2 11 2 0 0 0 0 0
0 0 0 0 6 6 6 0 0 0 0
0 0 0 0 6 14 0 0 0 0 0
0 0 0 0 0 6 6 0 0 0 0
0 0 0 3 3 3 0 0 0 0 0
0 0 0 0 3 3 3 3 0 0 0
0 0 0 1 1 1 1 1 0 0 0
0 0 0 0 1 1 1 1 0 0 0
0 0 0 0 6 6 6 0 0 0 0
0 0 0 0 6 6 6 0 0 0 0
0 0 0 0 6 14 0 0 0 0 0
0 0 0 0 3 3 3 0 0 0 0
0 0 0 3 3 3 3 0 0 0 0
0 0 0 0 0 3 3 0 0 0 0
0 0 0 0 0 0 0 0 0 0 0
0 0 0 0 0 0 0 0 0 0 0
0 0 0 0 0 0 0 0 0 0 0
0 0 0 0 0 0 0 0 0 0 0
0 0 0 0 0 0 0 0 0 0 0
0 0 0 0 0 0 0 0 0 0 0
0 0 0 0 0 0 0 0 0 0 0
0 0 0 0 0 0 0 0 0 0 0
0 0 0 0 0 0 0 0 0 0 0
0 0 0 0 0 0 0 0 0 0 0
0 0 0 0 0 0 0 0 0 0 0
0 0 0 0 0 0 0 0 0 0 0
0 0 0 0 0 0 0 0 0 0 0
0 0 0 0 0 0 0 0 0 0 0
0 0 0 0 0 0 0 0 0 0 0
0 0 0 0 0 0 0 0 0 0 0
0 0 0 0 0 0 0 0 0 0 0
0 0 0 0 0 0 0 0 0 0 0
0 0 0 0 0 0 0 0 0 0 0
0 0 0 0 0 0 0 0 0 0 0
0 0 0 0 0 0 0 0 0 0 0
0 0 0 0 0 0 0 0 0 0 0
0 0 0 0 0 0 0 0 0 0 0
0 0 0 0 0 0 0 0 0 0 0
0 0 0 0 0 0 0 0 0 0 0
0 0 0 0 0 0 0 0 0 0 0
0 0 0 0 0 0 0 0 0 0 0
0 0 0 0 0 0 0 0 0 0 0
0 0 0 0 0 0 0 0 0 0 0
0 0 0 0 0 0 0 0 0 0 0
0 0 0 0 0 0 0 0 0 0 0
0 0 0 0 0 0 0 0 0 0 0
0 0 0 0 0 0 0 0 0 0 0
0 0 0 0 0 0 0 0 0 0 0
0 0 0 0 0 0 0 0 0 0 0
0 0 0 0 0 0 0 0 0 0 0
0 0 0 0 0 0 0 0 0 0 0
0 0 0 0 0 0 0 0 0 0 0
0 0 0 0 0 0 0 0 0 0 0