MODE 2
SIZE 11/70
LIMIT 0/18
COLOR LIMIT 4
STARS 500/2500/4600
POWERUPS 1/1/0/0
0 0 3 3 3 23 3 3 3 0 0
0 0 1 2 1 2 1 1 0 0 0
0 0 0 1 22 1 2 1 0 0 0
0 0 0 5 5 5 5 0 0 0 0
0 0 0 0 3 22 3 0 0 0 0
0 0 0 3 2 3 0 0 0 0 0
0 0 0 0 3 2 3 0 0 0 0
0 0 0 3 2 3 0 0 0 0 0
0 0 0 0 3 2 3 0 0 0 0
0 0 0 3 2 3 0 0 0 0 0
0 0 0 0 3 2 3 0 0 0 0
0 0 1 5 1 5 1 0 0 0 0
0 0 0 1 5 1 5 1 0 0 0
0 0 0 1 5 1 5 1 0 0 0
0 0 0 0 1 5 1 5 1 0 0
0 0 0 2 2 8 2 2 0 0 0
0 0 0 0 2 2 2 2 0 0 0
0 0 0 6 6 6 6 6 0 0 0
0 0 0 0 6 6 6 6 0 0 0
0 0 0 0 6 6 6 0 0 0 0
0 0 0 0 0 6 6 0 0 0 0
0 0 0 0 4 6 4 0 0 0 0
0 0 0 0 4 4 4 4 0 0 0
0 0 0 4 4 4 4 0 0 0 0
0 0 0 0 2 4 4 2 0 0 0
0 0 0 0 2 2 2 0 0 0 0
0 0 0 0 0 2 2 0 0 0 0
0 0 0 0 0 2 0 0 0 0 0
0 0 0 0 0 0 0 0 0 0 0
0 0 0 0 0 0 0 0 0 0 0
0 0 0 0 0 0 0 0 0 0 0
0 0 0 0 0 0 0 0 0 0 0
0 0 0 0 0 0 0 0 0 0 0
0 0 0 0 0 0 0 0 0 0 0
0 0 0 0 0 0 0 0 0 0 0
0 0 0 0 0 0 0 0 0 0 0
0 0 0 0 0 0 0 0 0 0 0
0 0 0 0 0 0 0 0 0 0 0
0 0 0 0 0 0 0 0 0 0 0
0 0 0 0 0 0 0 0 0 0 0
0 0 0 0 0 0 0 0 0 0 0
0 0 0 0 0 0 0 0 0 0 0
0 0 0 0 0 0 0 0 0 0 0
0 0 0 0 0 0 0 0 0 0 0
0 0 0 0 0 0 0 0 0 0 0
0 0 0 0 0 0 0 0 0 0 0
0 0 0 0 0 0 0 0 0 0 0
0 0 0 0 0 0 0 0 0 0 0
0 0 0 0 0 0 0 0 0 0 0
0 0 0 0 0 0 0 0 0 0 0
0 0 0 0 0 0 0 0 0 0 0
0 0 0 0 0 0 0 0 0 0 0
0 0 0 0 0 0 0 0 0 0 0
0 0 0 0 0 0 0 0 0 0 0
0 0 0 0 0 0 0 0 0 0 0
0 0 0 0 0 0 0 0 0 0 0
0 0 0 0 0 0 0 0 0 0 0
0 0 0 0 0 0 0 0 0 0 0
0 0 0 0 0 0 0 0 0 0 0
0 0 0 0 0 0 0 0 0 0 0
0 0 0 0 0 0 0 0 0 0 0
0 0 0 0 0 0 0 0 0 0 0
0 0 0 0 0 0 0 0 0 0 0
0 0 0 0 0 0 0 0 0 0 0
0 0 0 0 0 0 0 0 0 0 0
0 0 0 0 0 0 0 0 0 0 0
0 0 0 0 0 0 0 0 0 0 0
0 0 0 0 0 0 0 0 0 0 0
0 0 0 0 0 0 0 0 0 0 0
0 0 0 0 0 0 0 0 0 0 0