MODE 2
SIZE 11/70
LIMIT 0/25
COLOR LIMIT 3
STARS 1000/3500/7000
POWERUPS 1/1/1/0
0 0 4 4 3 3 22 2 0 0 0
0 0 4 4 3 3 2 2 0 0 0
0 0 0 4 4 3 3 2 2 0 0
0 0 0 4 4 3 3 11 2 0 0
0 0 0 0 4 4 12 3 2 2 0
0 0 0 0 1 1 1 1 1 0 0
0 0 0 0 1 1 1 1 1 0 0
0 0 0 2 2 5 5 5 0 0 0
0 0 0 2 11 5 15 5 0 0 0
0 0 2 2 5 5 5 0 0 0 0
0 0 2 2 5 5 5 0 0 0 0
0 0 6 6 6 6 6 0 0 0 0
0 0 0 6 6 14 6 6 0 0 0
0 0 0 1 1 2 2 0 0 0 0
0 0 0 0 1 1 2 2 0 0 0
0 0 0 1 1 1 2 2 0 0 0
0 0 0 0 0 1 1 11 2 0 0
0 0 0 4 4 4 4 4 0 0 0
0 0 0 4 4 13 4 4 0 0 0
0 0 0 5 5 6 6 2 0 0 0
0 0 0 5 5 6 14 2 0 0 0
0 0 5 15 6 6 2 0 0 0 0
0 0 5 5 6 6 2 0 0 0 0
0 0 2 2 11 2 2 0 0 0 0
0 0 0 2 2 2 2 2 0 0 0
0 0 4 4 4 4 4 0 0 0 0
0 0 0 4 13 4 4 0 0 0 0
0 0 0 3 3 3 3 0 0 0 0
0 0 0 0 3 12 3 3 0 0 0
0 0 0 3 3 3 3 3 0 0 0
0 0 0 0 0 0 0 0 0 0 0
0 0 0 0 0 0 0 0 0 0 0
0 0 0 0 0 0 0 0 0 0 0
0 0 0 0 0 0 0 0 0 0 0
0 0 0 0 0 0 0 0 0 0 0
0 0 0 0 0 0 0 0 0 0 0
0 0 0 0 0 0 0 0 0 0 0
0 0 0 0 0 0 0 0 0 0 0
0 0 0 0 0 0 0 0 0 0 0
0 0 0 0 0 0 0 0 0 0 0
0 0 0 0 0 0 0 0 0 0 0
0 0 0 0 0 0 0 0 0 0 0
0 0 0 0 0 0 0 0 0 0 0
0 0 0 0 0 0 0 0 0 0 0
0 0 0 0 0 0 0 0 0 0 0
0 0 0 0 0 0 0 0 0 0 0
0 0 0 0 0 0 0 0 0 0 0
0 0 0 0 0 0 0 0 0 0 0
0 0 0 0 0 0 0 0 0 0 0
0 0 0 0 0 0 0 0 0 0 0
0 0 0 0 0 0 0 0 0 0 0
0 0 0 0 0 0 0 0 0 0 0
0 0 0 0 0 0 0 0 0 0 0
0 0 0 0 0 0 0 0 0 0 0
0 0 0 0 0 0 0 0 0 0 0
0 0 0 0 0 0 0 0 0 0 0
0 0 0 0 0 0 0 0 0 0 0
0 0 0 0 0 0 0 0 0 0 0
0 0 0 0 0 0 0 0 0 0 0
0 0 0 0 0 0 0 0 0 0 0
0 0 0 0 0 0 0 0 0 0 0
0 0 0 0 0 0 0 0 0 0 0
0 0 0 0 0 0 0 0 0 0 0
0 0 0 0 0 0 0 0 0 0 0
0 0 0 0 0 0 0 0 0 0 0
0 0 0 0 0 0 0 0 0 0 0
0 0 0 0 0 0 0 0 0 0 0
0 0 0 0 0 0 0 0 0 0 0
0 0 0 0 0 0 0 0 0 0 0
0 0 0 0 0 0 0 0 0 0 0